11111111111111111111111111111111
10100000000000000000000000000001
1000000100000C000100001000E00001
1100000P001000000E00000C01000001
10001000000100000001000000000001
10000010000000000000000C00000101
10000000C0000C001001000010000001
10010000000C00100000000000000001
1000000100000E000000000C00000001
100C0000000000001000000000000011
1001000010000000C000101000001111
100000C10000C01000000000E0000C01
100100010E0000001010000000001001
100000000000001000000C0000100001
11111111111111111111111111111111
